#domain
hospital
#levelname
cbs06
#colors
blue: 0, 2, A
red: 1
#initial
++++++++++
+0 A     +
+12   ++++
+        +
+     ++ +
+      + +
++++++++++
#goal
++++++++++
+        +
+     ++++
+        +
+     ++0+
+    1 +A+
++++++++++
#end
