#domain
hospital
#levelname
cbs05
#colors
blue: 0
red: 1
green: 2, 3
#initial
+++++++++
+0+++++ +
+3+++++ +
+       +
+1+++++ +
+2  +   +
+++++++++
#goal
+++++++++
+ +++++3+
+ +++++1+
+       +
+ +++++ +
+   + 02+
+++++++++
#end