#domain
hospital
#levelname
cbs01
#colors
blue: 0, 2
red: 1
#initial
+++++++++
+0      +
+++++++++
+1      +
+++++++++
+2      +
+++++++++
#goal
+++++++++
+      0+
+++++++++
+     1 +
+++++++++
+   2   +
+++++++++
#end