#domain
hospital
#levelname
MAExample
#colors
red: 0, A
green: 1, B
#initial
++++++++++
+        +
+        +
+        +
+        +
++++  ++++
+0BB     +
+        +
+1AA     +
++++  ++++
+        +
+        +
+        +
+        +
++++++++++
#goal
++++++++++
+        +
+        +
+        +
+        +
++++  ++++
+1     AA+
+        +
+0     BB+
++++  ++++
+        +
+        +
+        +
+        +
++++++++++
#end